path	@id
/long_name	
/standard_name	
/units	
/_ARRAY_DIMENSIONS	
/Conventions	
/units_metadata	
/cell_methods	
/created_by	
/date	http://purl.org/dc/terms/date
/crs_wkt	
/geotransform	
/proj4	
/spatial_ref	
/epsg_code	
/grid_mapping_name	
/inverse_flattening	
/semi_major_axis	
/ancillary_variables	
/axis	http://www.opengis.net/cis/1.1/axis
/grid_mapping	
/sdn_parameter_name	
/sdn_parameter_urn	
/sdn_uom_name	
/sdn_uom_urn	
